0,0,0,0,ce,0,0,0,0,0
0,0,0,0,0,0,0,0,0,0
0,0,0,0,0,0,0,0,0,0
0,0,0,0,0,0,0,pb,0,0
0,0,0,0,cp,0,0,0,0,0
0,0,0,0,0,0,0,pe,0,0
0,0,0,0,cb,0,0,0,0,0